000000000
0   e   0
0 00000 0
0 0fff0 0
0 0fff0 0
0 0fff0 0
0 00 00 0
0       0
0       0
000 p 000
000000000